anal	sessualità
anus	sessualità
arse	sessualità
ass	sessualità
ballsack	sessualità
balls	sessualità
bastard	comune
bitch	comune
biatch	comune
bloody	comune
blowjob	sessualità
blow job	sessualità
bollock	comune
bollok	comune
boner	sessualità
boob	sessualità
bugger	sessualità
bum	sessualità
butt	sessualità
buttplug	sessualità
clitoris	sessualità
cock	sessualità
coomers	sessualità
coon	discriminatorio
crap	comune
cunt	sessualità
damn	comune
dick	sessualità
dildo	sessualità
dyke	discriminatorio
fag	discriminatorio
feck	comune
fellate	sessualità
fellatio	sessualità
felching	sessualità
fuck	sessualità
fucked up	comune
fudgepacker	discriminatorio
Fucking balls	comune
fudge packer	discriminatorio
flange	sessualità
goddamn	religione
gay	sessualità
hell	comune
homo	discriminatorio
human dogshit	discriminatorio
jerk	comune
jizz	sessualità
knobend	sessualità
knob end	sessualità
labia	sessualità
lesbian	sessualità
lmao	comune
lmfao	comune
muff	sessualità
nigger	discriminatorio
nigga	discriminatorio
omg	religione
penis	sessualità
piss	comune
Piss and shit	comune
poop	comune
prick	comune
pube	sessualità
pussy	sessualità
queer	discriminatorio
scrotum	sessualità
sex	sessualità
shit	comune
s hit	comune
sh1t	comune
slut	sessualità
smegma	sessualità
spunk	sessualità
stupid	comune
tit	sessualità
tosser	comune
turd	comune
twat	sessualità
vagina	sessualità
wank	sessualità
whore	sessualità
wtf	comune